    #######
    #### .####
     ##      #
    ##   B# B#
   ##        #
  ## & #  #  #######
 ##   #####       .#
##   ###  #  B    .#
########  ##########
