#########
#.  .  .#
#  BBB  #
#. B&B .#
#  BBB  #
#.  .  .#
#########
