###############
#  ######### .#
# .######### .#
#&     #      #
#BB B         #
#. #########  #
#  #########  #
###############
