##########
#  #  #  #
#        #
### #### #
#    B   #
#. B   & #
#.#  #   #
#X#  #   #
##########
