     ###
    #  # ####
   #   ###  #
  # B       #
 #   &B  #  #
### B ####  #
  #   #..   #
 ##  ##.   ##
 #       ####
 #       ##
 ##########
