#####
#   #
# B # ###
# B # #X#
### ###.#
 ## &  .#
 #   #  #
 #   ####
 #####
