#######
#     ######
# #        #
# B #  # # #
#.#.#B B B&#
# .       ##
# # #######
#.  #
#####
