     #####
     # . #
     #   #
     #   ######
###### B      #
# .      B   .#
#   BB &      #
#        ######
######   #
     #   #
     #   #
     # . #
     #####
     